################
#@...#....#..#.#
###..#..#.#....#
#...###.#####..#
#....#.........#
##.###.#..#..###
#....###.##..#.#
#..#.#....#....#
####......####.#
#..#.####...#..#
#..#.#......#..#
#....########..#
#.#...........##
#.#.########...#
#.#........#...#
##############&#