################
#.....#@.#.....#
#####.##.####..#
#...#..#....##.#
#.#.##.#.####..#
#.#......#.....#
#.######.#######
#..#...###...#.#
#..#.#...##..#.#
#..###.#.#..##.#
##.....#.#.....#
#..#####.#####.#
#......#...#.#.#
######.#####...#
#..............#
###&############